0111010100110000
1000110001100110
0000100011110101
0100111111000000
0000011010101110
0000011010101110
0100111010101000
0000000011011111
0111110101000000
0000001100011111
1110100011001000
0000100010011111
1011111100000000
1110101011000000
0001001100010111
0111000101110000
0010111100110000
0000001101010111
1110101010001000
0010011011001100
0010001000110111
1000100011001110
0111000101110000
0111010111000000
0111010100110000
0000100010011111
1000111001110000
0011011111000000
1110101110000000
0000001011101011
1110101010100000
0111110010001000
1111100100010000
1110101011000000
0000000011011111
1100100011101000
1110101011000000
0111110101000000
1111000100110000
0000011001010111
0100110011110000
0111110110000000
0011001100010011
0000001001101111
0111000100110001
1100100011100010
0110001011100010
0010111101100000
0000100011001111
0011001001110001
1111101010000000
0000110010101110
1100111110000000
0000001101010111
0000001000111111
1110101011000000
1111100110000000
0000011010101110
0000010101010111
1110010011001000
0110111000110000
0000000110011111
0111010111000000
0000011010101110
1110101010001000
0000001100101111
0111110110000000
1110101010001000
0110001011110000
0100010001110110
0111000101110000
0000000110011111
0111000100010011
0000001000111111
1100011011001000
0111010100110000
0111000101110000
0111000100110001
1111011100000000
0000010011111100
0000000010111111
0000001101010111
0000011100010111
0111000101110000
0100111011000100
0000000100111111
1100100011101000
0100011111100000
0000001101010111
0011011001001100
0000000001111111
0000000110011111
0000010011101110
1110001001100100
0010111000100011
0000110101110010
0000101111100100
1110101010001000
0111000101110000
0001001100010111
