1110000000000000000000000000000000000000000000000000000000000001
0000000011111111111110000000000000000000000000000111111111111100
0000000000000000000000000000000000000000000000000000000000000000
0000000000000000000000000000011000000110000000000000000000000000
0000000000000000000000000000000111111110000000000000000000000000
0000000000000000000000110000000000000000000000000000000000000000
0000000000000000000000110000000000000000000000000000000000000000
0000000000000000000000000000000000000000000000000000000000000000
0000000000000000000000000000000000000000000000000000000000000000
0000000000000000001100000000000000000000000000000000000000000000
0000000000000000000000000000000000000111111110000000000000000000
0000000000000000000000000000000000000011111000000000000000000000
0000000000000000000000000000000000000000001000000000000000000000
0000000000000000000000000000000000000000000000000000000000000000
0000000000000111000000000000000000000000000000011110000000000000
0000000000000000000000000000000000000000000000001110000000000000
0000000000000000000000000000000000000000000000000000000000000000
0000000000000000000000000000000000000000000000000000000000000000
0000000000000000000000000000000000000000000000000000000000000000
0011111111100000000000000000000000000000000000000000000000000000
0000000000000000000000000000000000000000000000000000011111111100
0000000000000000000000000000000000000000000000000000000000000000
0000000000000000000000000000000000000000000000000000000000000000
0000000000000000000000000001111100000000000000000000000000000000
0000000001111110000000011111111011111000000000000000000000000000
0000000000111100000000000000001110011000000000000000000000000000
0000000000001100000000000000000000000000000000000000000000000000
0000000000000000000000000000000000000000000000000000000000000000
0000000000000000000000000000000000000000000000000001111111100000
0000000000000000000000000000000000000000000000011111111111000000
0000000000000000000000000000000000000000000000000111111111000000
0000000000000000000000000000000000000000000000000000111000000000
0000000000000000000000000000000000000000000000000000000100000000
0000000000000000000000000000000000000000000000000000000000000000
0000000000000000000000000000000000000000000000000000000000000000
0000000000000000000000000000000000000000000000000000000000000000
0000000000000000000000000000000000000000000000000000000000000000
0000000000000000000000000000000000000000000011000000000000000000
0000000000000000000001111110000000000011111110000000000000000000
0000000000000000000111000011000000000000000000000000000000000000
0000000000000000000000000000000000000000000000000000000000000000
1000000000000000000000000000000000000000000000000000000000000001
