0000000000000000000000000000000000000000000000000000110000000001
0000000000000000000000000000000000000000000000111111000000000001
0000000000000000000000000000000000000000111111100000000000000011
0000000000000000000000000000000000000001100000000000000000000111
0000000000000000000000000000000000000000000000000000000000001101
0000000000000000000000000000000000000000000000000000000000001111
0000000000000000000000000000110000000000000000000000000000001111
0000000000000000000011111111110000000000000000000000000000000111
0000000000000000000000000000000000000000000000000000000000011111
0000000000000000000000000000000000000000000000000000000000011111
0000000000000000000000000000000000000000000000000000000000111111
0000100000000000000000000000000000000000000000000000000000011111
0000011111100000000000000000000000000000000000000000000000001111
0000000000011110000000000000000000000000000000000000000000000111
0000000000000000000000000000000000000000000000000000000000000111
0000000000000000000000011111100000000000000000001111111110000011
0000000000000000000000000000000000011110000001110000000000000011
0000000000000000000000000000000000000001111110000000000000000001
0000000000000000000000000000000000000000000000000000000000000011
0000000000000000000000000000000000000000000000000000000000000001
0000000000000000000000000000000000000000000000000000000000000011
0000000000000000000000000000000000000000000000000000000000000011
0000000000000000000000000000000000000000000000000000000000000011
0000000111111110000000000000000000000000000000000000000000000011
0000000000000011111000000000000000000000000000000000000000000111
0000000000000000000111110000000000000000000000000000000000000111
0000000000000000000000000000000000000000000000000000000000000111
0000000000000000000000000000000000000000000000000000011111100111
0000000000000000000000000000000000000000111111111111100000000111
0000000000000000000000000000001111111111000000000000000000000111
0111100000000000000000000000000000000000000000000000000000000111
0100000000000000000000000000000000000000000000000000000000000111
0000000000000000000000000000000000000000000000000000000000000111
0000000000000000000000000000000000000000000000000000000000000111
0000001100000000000000001111111100000000000000000000000000000111
0000000100000000000000000000000000000000000000000000000000000111
0000000000000000000000000000000000000000000000000000000000000111
0000000000000000000000000000000000000000000000000000000000000111
0000000000000000000000000000000000000000000000000000000000000011
0000000001111111111111110000000000000000011111100000000000000011
0000000000000000000000001000000000000001100000111110000000000011
0000000000000000000000000000000000000000000000000000000000000011
