0000000000000000000000000000000000000000000000000000000000000001
0000000000000000000000000000000000000000000000000000000000000110
0000000000000000000000000000000000000000000000000000000000000111
0000000000000000000000000000000000000000000000000000000000000011
0000000000000011111100000000000000000001100000000000000000000010
0000000000001110000011111111111111111111111000000000000000000010
0000000000011000000000000000000000000000000110000000000000000011
0000000000000000000000000000000000000000000010000000000000000010
0000000000000000000000000000000000000000000000000000000000000011
0000000000000000000000000000000000000000000000000000000000000011
0000000000000000000000000000000000000000000000000000000000000011
0000000000000000000000000000000000000000000000000000000000000001
0000000000000000000000000000000000000000000000000000000000000011
0000000000000000000000000000000000000000000000000000000000000011
0000000000000000000000000000000000000000000000000000000000000011
0000000000000000000000000000000000000000000000000000000000000111
0000000000000000000000000000000000001100000000000000000001111101
0000000000000000000000000000000000010100000000000000000111100001
0000000000000000000000000000000000001110000000000000111110000001
1100000000000000000000000000000000000110000000000000000000000001
0100000000000000000000000000000000000110000000000000000000000001
0010000000000000000000011111100000000110000000000000000000000001
0001100000000000000000000000000000000110000000000000000000000011
0000000000000000000000000000000000000110000000000000000000000010
0000000000000000001111000000000000000010000100000000000000000011
0000000000000000110000000000000000000011111111000000000000000001
0000000000000000000000000000000000000001111111110000000000000011
0000000000000000000000000000000000000000110000010000000000000011
0000000000000000000000000000000000000000000000011100000000000011
0000000011100000000000000000000000000000000000000011110000000011
0000001100000000000000000000000000000000000000000000000000000010
0000000000000000000000000000000000000000000000000000000000000010
0000000000000000000000000000000000000000000000000000000000000010
0000000000000000000000000000000000000000000000000000000000000011
0000000000000000000000000000000000000000000000000000000000000011
0000000000000000000000000000000000000000000000000000000000000010
0000000000000000000000000000000000000000000000000000000000000110
0000000000000000000000000000000000000000000000000000000000011100
0000000000000000000000000000000000000000000000000000000000010111
0000011100000000000000000000000000000000000001111111111111111110
0111111000000111111111111111111111111111111111000000111110011110
1111111111111111000000000000000000000000000111111111111111110000
