1000000000000000000000000000000000000000000000000000000000000001
1100000000000000011111111000000000000000000000000000000000000001
1100000000000000000000000000000000011111111100000000000000000010
1100000000000000000000000000000000000000000000000000000000000010
1100000000000001000000000000000000000000000000000000000000000010
0100000000111110000000000000000000000000000000000000000000000010
1100000011000000000000000000000000000000000000000000000000000001
1100000000000000000000000000000000000000000000000000000000000001
1100000000000000000000000000000000000000000000000000000000000011
1100000000000000000000000000000000000000000000000000000000000011
1100000000000000000000000000111110000000000000000000000000000011
1100000000000000000000000000100010000000000000000000000000000011
1110000000000000000000000000000000000000000000000000000000000011
1111110000000000000000000000000000000000000000000000000000000111
1000000000000000000000000000000000000000000000000000000000000111
1000000000000000000000000000000000000000000000000000000000000111
1000000000000000000000000000000000000000000000000000000000000111
1000000000000001100000000000000000000000000000001111100000000101
1100000000001111110000000000000000000000000000000000000000001101
0100000000000000000000000000000000000000000000000000000000001101
0110000000000000000000000000000000000000000000000000000000001101
0110000000000000000000000000000000000000000000000000000000011111
0101000000000000000000000001111111000000000000000000000000011010
0101000011100000000000000000000000000000000000000000000000011010
0101000000000000000000000000000000000000000000000000000000111010
0101000000000000000000000000000000000000000000000000000000111010
0110100000000000000000000000000000000000000000000000000001111010
0110100000000000000000000000000000000000000000000000000010101110
0110100000000000000000000000000000000000000000000000000010101110
0110010000000000000000000000000000001111111100000000000101001110
0011010000000000000000000000000000000000000000000000001101011111
0011101000001000001110000000000000000000000000000000001011011011
0011011000001111111000000000000000000000000000000000110111011011
1010111000000000000000000000000000000000000000000001100111011011
1010101000000000000000000000000000000000000000000001011101011011
1110101000000000000000000000000000000000000000000111101111011111
1101110100000000000000000000000000000000000000011011011101111111
1011010100000000000000000000000000000000000001101111111101111011
1001011100000000000000000000000000000000011111111111011111111111
1111110110000000000000000000000011111111111111111100111111010111
0111011111100000000000000000111110000000011111111111111111111100
0111111111111111111111111111111111111111110011111111111111111111
