1100000000000000000000000000000000000000000000000000000000000011
1110000000000000000000000111111110000000000000000000000000000011
1110000000000000000000000000000000000000000000000000000000000011
1101000000000000000000000000000000000000000000000000000000000011
1111100000000000000000000000000000000000000000000000000000000011
1110100000111110000000000000000000000000000000000000000000000011
1111100000000000000000000000000000000000000000000000000000000011
1111010000000000000000000000000000000000000000000000000000000011
1111010000000000000000000000000000000000000000000000000000000101
1011110000000000000000000000111100011111111000001111111000000101
1011110000000000000000000000000000000000000000000000000000001101
1011111000000000000000000000000000000000000000000000000000011111
1011111100000000000000000000000000000000000000000000000000111110
1011111110000000000000000000000000000000000000000000000001101110
1011111110000000000000000000000000000000000000000000000001111110
1111111111100000000000000000000000000000000000000000000001111110
1111111101110000000000000000000000000000000000000000000001111110
1111111111111100000000000000000000000000000000000000000011111110
1110111111111111100000000000000000000000000000011100000011110111
1111111100111111111111000000000000000000000000000110000011111111
1111111111110000111110111100000000000000000000000000000011111111
1010101000000000000001111111110000000000000000000000000011111111
1011110000000000000000000000000000000000000000000000000011111111
1101110000000000000000000000000000000000000000000000000011101110
1101100000000000000000000000000000000000000000000000000001101110
1101000000000000000000000000000000000000000000000000011111111111
1111000000000000000000000000000000000000000000000000000111111101
1110000000000000000000000000000000000000000000000000000101111111
1110000000000000000000000000000000000000000000000000001101111111
1010000000000000000000000000000000000000000000000000111011111111
1110000000000000000000000000000000000000000000000011111111111111
1100000000000000000000000000000000000000000000001111111111111111
1100000000000000000011100000000000000000000000011111111101111111
1100000000000000001111111000000000000000000011111111100000011111
1100000000000000000000000000000000000000111111111100000000001111
1100000000000000000000000000000000000000000000000000000000001111
1000000000000000000000000000000000000000000000000000000000001111
1000000000000000000000000000000000000000000000000000000000001111
1000000000000000000000000000000000000000000000000000000000000111
1000000000000000000000111111100000001111100000000000000000000001
1100000000000000000000000000000000000000000000000000000000000001
1000000000000000000000000000000000000000000000000000000000000001
