1111111111111111111111111111111111111111111111111111111111111111
1100000000111111111111111111111111111111111111111111111000000000
0000000000000000111111111111111111111111111100000000000000000000
0000000000000000000001111111111111111111111111000000000000000000
0000000000000000000111111111111111111101010000000000000000000000
0000000000000000000001111111111111111111111100000000000000000000
0000000000000000000000001111111111111111100000000000000000000000
0000000000000000000000000111001111110111000000000000000000000000
0000000000000000000000000011111111111111110000000000000000000000
0000000000000000000000001111111111111111110000000000000000000000
0000000000000000000000000001111101111110000000000000000000000000
0000000000000000000000011111111111110100000000001100100000000000
0000000000000000000000000001111111111111000000111111000000000000
0000000000000000000000000000001111111100000000000000000000000000
0000000000000000000000000000111111111111000000000000000000000000
0000000000000000000000000000001111110000000000000000000000000000
0000000000000000000000000000000011111100000000000000000000000000
0000000011110000000000000000001111110000000000000000000000110000
0000000001111000000000000000000011110000000000000000000011111100
0000000001111111000000000000000011110000000000000000000000000000
0000000000000011100000000000000011111000000000000000000000000000
0000000000000000000000000000001111111000000000000000000000000000
0000000000000000000000000000000111110000000000000000000000000000
0000000000000000000000111000000001100000000000000000000000000000
0000000000000000000011110000000001100000000000000000000000000000
0000000000000000000000000000000001100000000000000011110000000000
0000000000000000000000000000000001100000000000000111111100000000
0000000000000000000000000000000001100000000000011111111110000000
0000000000000000000000000000000000100000000000111110001000000000
0000000000000000000000000000000000000000000001111000000000000000
0000000000001100000000000000000000000000000001000000000000000000
0000000011100111110000000000000000000000000000000000000000000000
0000000000011110000000000000000000000000000000000000000000000000
0000000000000000000000000011100000000001100000000000000000000000
0000000000000000000000111111111111100001111000000000000000000000
0000000000000000000000011111111111111111111100000000000000000000
0000000000000000000000000000000000000000000000000000000000000000
0000000000000000000000000000000000000000000000000000000000000000
0000000000000000000000000000000000000000000000000001111100000000
0000000000000000000000000000000000000000000000111111110000000000
0000000000000001111110000000000000000000000000100000000000000000
0000000000000001100011111100000000000000000000000000000000000000
