1111111111111101111111111011111111100111111001111111111100000011
0000000000111110000000001111111111011000000111111111111110011110
0000000000001110000000000000111111101111111111111110011111111111
0000000000000000000000000000000001001100111101111111111111110101
0000000000000000000000000000000000000000000011111111101111111111
0000000000000000000000000000000000000000000000000000000001111100
0000000000000000000000000000000000000000000000000000000001011100
0000000000000000000000000000000000000000000000000000000000011101
0000000000000000000000000000000000000000000000000000000000001001
0000000000000000000000000000000000000000000000000000000000000011
0000000000000000000000000000000000000000000000000000000000000001
0000000000000000000000000000000000000000000000000000000000000001
0000000000000000000000000000000000000000000000000000000000000001
0000000000000000000000000000000000000000000000000000000000000001
0000000000000000000000000000000000000000000000000000000000000011
0000000000000000000000000000000000000000000000000000000000000011
0000001111110000000000000000000000000000000000000000000000000010
0000000000010000000000000000000000000000000000000000000000000010
0000000000000000000000000000000000000000000000000000000000000010
0000000000000000000000000000000000000000000000000000000000000010
0000000000000000000000000001111000000000000000000000000000000010
0000000000000000000000000000000000000000000000000000000000000001
0000000000000111110000000000000000000000000000000000000000000001
0000000000000000000000000000000000000000000000000000000000000001
0000000000000000000000000000000000000000000000000000000000000001
0000000000000000000000000000000000000000000000000000000000000001
0000000000000000000000000000000000000000000000000000000000000000
0000000000000000000000000000000000011100000000000000000000000000
0000000000000000000000000000000000000000000000000000000000000001
0000000000000000000000000000000000000000000000000000000000000001
0000000000000000000000000000000000000000000000000000000000000001
0000000000000000000000000000000000000000000000000000000000000001
0000000000000000000000000000000000000000000000000000000000000001
0000000000000000000000000000000000000000000000000000000000000001
0000000000000000000000000000011000000000000000000000000111100001
0000000000000000000000000000110000000000000000000001111000000001
0000000000000000000000000000000000000000000000000001000000000001
0000000000000000000000000000000000000000000000000001000000000001
0000000011111100000000000000000000000000000000000001000000000001
0001111110000000000000000000000000000000000001111110000000000001
0000000000000000000000000000000000000000011111000000000000000001
0000000000000000000000000000000000000011110000000000000000000001
