1111111110001111111111111011000011111110111111011111111100000011
0000001111111000000000111111111110000001111111111111111110111110
0000000000001110000000000000100000000000001100001111111111111111
0000000000000000000000000011000000000000000111000000101111110101
0000000000000000000000011100000000000000000011111111111111111111
0000000000000000000001110000000000000000000000000000001111111110
0000000000000010001110000000000000000000000000000000000011011110
0000000110001111111000000000000000000000000000000000000000111111
0000000011111000000000000000000000000000000000000000000000011111
0000000000000000000000000000000000000000000000000000000000000011
0000000000000000000000000000000000000000000000000000000000000101
0000000000000000000000000000000000000000000000000000000000000111
0000000000000000000000000000000000000000001100111000000000000111
0000000000000000000000000000000000000000000111101100000000000111
0000000000000000000000000000000000000000000000111110000000000011
0000000000000000000000000000000000000000000000001111000000000011
0000000000000000000000000000000000000000000000000111110000001110
0000000000000000000000000000000000000000000000000001111111111111
0000000000000000000000000000000000000000000000000000000001111111
0000000000000000000000000000000000000000000000000000000000011111
0000111100000000000000000000000000000000000000000000000000000111
0000111111111110000000100000000000000000000000000000000000000001
0011100000000011111111000000000000000000000000000000000000000001
0000000000000000000000000000000000000000000000000000000000000011
0000000000000000000000000000000000000000000000000000000000000011
0000000000000000000000000000000000000111001100000000000000000011
0000000000000000000000000000000000000001111000000000000000000010
0000000000000000000000000000000000000000000000000000000000000110
0000000000000000000000000000000000000000000000000000000000000101
0000000000000000000000000000000000000000000000000000000000000101
0000000000000000000000000000000000000000000000000000000000000111
0000000000000000000000000000000000000000000000000000000000000011
0000000000000000000000000000000000000000000000000000000000000011
0000000000000000000000000000000000000000000000000000000000000001
0000000000000000000000000000000000000000000000000000000000000001
0000000000000000000000000000000000000000000000000000000000000011
0000000000000000000000000000000000000000000000000000000000000010
0000000000000000000000000000000000000000000000000000000000011110
0000000011111111000000000000000000000000001111100000000111111111
0001111111111101111000000000000000000000110001111111111111000001
0011111111111111111000000111111111111111011111011011001111100111
1110000000011111111111111111100000000011110000000001000000000001
