0111111111111111111111111111111111111111111111111111111111111110
1110111111111100000000000000000000000000000000000000000011111111
0111111110000000000000000000000000000000000000000000000000000011
0110000000000000000000000000000000000000000000000000000000000011
0110000000000000000000000000000000000000000000000000000000000011
0110000000000000000000000000000000000000000000000000000000000011
1110000000000000000000000000000000000000000000000000000000000001
1110000000000000000000000000000000000000000000000000000000000001
0111110000000000000000000000000000000000000000000000000000000001
0110111111111111100000000000000000000000000011111111100000000001
1101111111101111111111111100000000000000000000000000000000000001
1100000000000000000000000000000000000000000000000000000000000001
1100000000000000000000000000000000000000000000000000001110000001
1100000000000000000000000000000000000000000000000000000000000001
0100000000000000000000000000000011111100000000000000000000000001
0100000000000000000000000000000000000000000000000000000000000001
0100000000000000000000000000000000000000000000000000000001000001
0100000000000000000000000000000000000000000000000000000001110001
0100000000000000000111000000000000000000000000000000000000000001
0100000000000000000000111111100000000000000000000000000000000001
1110000000000000000000000000000000000000000000000000000000000001
1111100000000000000000000000000000000000000000000000000000000001
1111111111110000000000000000000000000000000000000000000000000111
1100000000000000000000000000000000000000000000000000000001000011
0100000000000000000000000000000000000000000000000000000111000011
0100000000000000000000000000000000000000000000000000000100000011
0100000000000000000000000000000000000000000000000000000000000011
0100000000000000000000000000000000000000000000000000000000000011
0100000000000000000000000000000000000000000000000000000000000011
0100000000000000000000000000000000000000000000000000000000000011
0100111100000000000000000000000000000000000000000000000000000011
0100000111000000000000000000000000000000000000000000000000000011
0100000000100000000000000000000000000000000000001100000000000011
0100000000010000000000000000000000000001111111110000000000000011
1000000000011000000000000000000000000001000000000000000000000011
1000000000000100000000000000000000000000000000000000000000000011
1000000000000110000000000000000000000000000000000000000000000011
1000000000000001110000000000000000000000000000000000000000000011
1000000000000000011100000000000000000000000000000000000000000001
1000000000000000000001111111110000000000000000000000000000000001
1000000000000000000110000000010000000000000000000000000000000001
1000000000000000000000000000000000000000000000000011111100000001
