1111111111111111001111000011111111111111111111111111111111111111
1000000000011111111111111111111100000000000000000000000000000000
0000000000001111100000000000000000000000000000000000000000000000
0000000000000111000000000000000000000000000000000000000000000000
0000000000000111000000000000000000000000000000000000000000000000
0000000000000111100000000000000000000000000000000000000000000000
0000000000000010111110000000000000000000000000000000000000000000
0000000000000001111111000000000000000000000000000000000000000000
0000000000000000000111111111111111000000000000000000000000000000
0000000000000000000000000111110000000000000000000000000000000000
0000000000000000000000000000000000000000110000000000000000000000
0000000000000000000000000000000000000000000000000000000000000000
0000000000000000000000000000000000000000000000110000000000000000
0000000000000000000000000000000000000000000000000000000000000000
0000000000000000000000000000000000000000000000000000000000000000
0000000000000000000000000000000000000000000000000000110000000000
0000000000000000000000000000000000000000000000000000000000000000
0000000000000000000000000000000000000000000000000000000000001100
0000000000000000000000000000000000000000000000000000000000001100
0000000000000000000000000000000000000000000000000000000000001100
0000000000000000000000000000000000000000000000000000000000000000
0000000000000000000000000000000000000000000000000000000000000000
0000001000000000000000000000000000000000000000000000000000000000
1111111100000000000000000000000000000000000000000000000110000000
0000000100000000000000000000000000000000000000000000000000000000
0000000000000000000000000000000000000000000000000000000000000000
0000000000000000000000000000000000000000000000000001100000000000
0000000000000000000000000000000000000000000000000001000000000000
0000000001111110000000000000000000000000000000000000000000000000
0000000000000000000000000000000000000000000000000000000000000000
0000000000000000000000000000000000000000000000000000000000000000
0000000000000000000000000000000000000000000000000000000000000000
0000000000000000000000000000000000000000000000000000000000000000
0000000000000000000000000000000000000000000000011100000000000000
0000000000000000011100000000000000000000000000000000000000000000
0000000000000000000000000000000000000000000000000000000000000000
0000000000000000000000000000000000000000000000000000000000000000
0000000000000000000000000000000000000000000000000000000000000000
0000000000000000000000000000000000000000000000000000000000000000
0000000000000001000000000000000000000000000000000000000000000000
0000000111111111111111111111111111111111101111111111110000000001
1111111111111111111111111111111111111111110111111111111111111111
