1111111010011111111111111111111111111111111111111111111111111111
1111111111111111111111111111111111111111111111111111111111110000
1111110111111111111111111111111111111111001111111111001000000000
1111011110000011111101101111111111101111110000011111001100000000
1011011111111111111111111111111111111111111111111011110100000000
1111111110011110111111111111111111111111101111100000000000000000
1011111000111111111000000011110000000000000000000000000000000000
1111111111111111111110011101000000000000000000000000000000000000
1111001110111110111110100000000000000000000000000000000000000000
1110111111111111111000000000000000000000000000000000000000000000
1111111011111111111110000000000000000000000000000000000000000000
1111111111110110011000000000000000000000000000000000000000000000
1111111111111111110000000000000000000000000000000000000000000000
1011111110111000000000000000000000000000000000000000000000000000
1111011111110000000000000000000000000000000000000000000000000000
1111011111110000000000000000000000000000000000000000000000000000
1010111111100000000000000000000000000000000000000000000000000000
1110111011100000000000000000000000000000000000000000000000001111
1111111111000000000000000000000000000000000000000000000000000000
1111111111000000000000000000000000000000000000000000000000000000
1111111111000000000000000000000000000000000000000000000000000000
1110111111100000000000000000000000000000000000000000000000000000
1010111111111111100000000000000000000000000000000000000000000000
1111111111111111111111000000000000000000000000000000000000000000
1101111111111111111111111111111000000000000000000000000000000000
1111110011111111011111111111110000000000000000000000000000000000
1111100000110111111110111100000000000000000000000000000000000000
1111100000000000110000000000000000000000000000000000000000000000
1111000000000000000000000000000000000000000000000000000000000000
1110000000000000000000000000000000000000000000000000000000000000
1110000000000000000000000000000000000000000000000000000000000000
1110000000000000000000000000000000000000000000000000000000000000
1100000000000000000000000000000000000000000000000000000000000000
1100000000000000000000000000000000000000000000000001000000000000
1100000000000000000000000000000000000000000001111111000000000000
1100000000000000000000000000000000000000011111100000000000000000
1100000000000000000000000000000000000000000000000000000000000000
1000000000000000000000000000000000000000000000000000000000000000
1000000000000000000000000000000000000000000000000000000000000000
1000000000000000001110000000000000000000000000000000000000000000
1000000000000000000011111111111000000000000000000000000000000000
1000000000000000000000011101111000000000000000000000000000000000
