0000000000000000000000000000000000000000000000000000000000000000
0000000000111111000000000000000000000000000000000000000000000000
0000000000000000111000000000000000000000000000000000000000000000
0000000000000000000110000000000000000000000000000000000000000000
0000000000000000000000000000000000000000000000000000000000000000
0000000000000000000000000000011000000000000000000000000000000000
0000000000000000000000001111101110000000000000000000000000000000
0000000000000000000000000000000011100000000000000000000000000000
0000000000000000000000000000000000000000000000000000000000000000
0000000000000000000000000000000000000000000100000000000000000000
0000000000000000000000000000000000000000000100000000000000000000
0000000000000000000000000000000000000000000100000000000000000000
0000000000000000000000000000000000000000000100000000000000000000
0000000000000000000000000000000000000000000100000000000000000000
0000000000000000000000000000000000000000000100000000000000000000
0000000000000000000000000000000000000000000100000000001100000000
0000000000000000000000000000000000000000001110000000000111111000
0000000000000000000000000000000000000000001110000000000000000000
0111000000000000000000000000000000000000001101000000000000000000
0000000000000000000000000000000000000000001101000000000000000000
0000000000000000000000000000000000000000001101000000000000000000
0000000000000000000000000000000000000000001111000000000000000000
0000000000001110000000000011111110000000001010100000000000000000
0000000000000100000000000011110000000000001011100000000000000000
0000000000011110000000000000000000000000001011010000000000000000
0000000000000110000000000000000000000000011110110000000000000000
0000000000000111000000000000000000000000011111010000000000000000
0000000000001111110000000000000000000000011111111000000000000000
0000000000011111110000000000000000000000011111111000000000000000
0000000000111110100000000000000000000000101111011100000000000000
0000000000001111111100000000000000000000111111011100000000000000
0000000000111111111000000000000000000001010111111100000000000000
0000000001111111111000000000000000000001010111101110000000000000
0000001111011111111100000000000000000001010111111110000000000000
0000000001111110110110000000000000000010111111011111000000000000
0000000001111111111111000000000000000010111111001111100000000000
0000000011101111111111000000000000000011111111111010100000000000
0000000011111111111111100000000000000111111111110111010000000000
0000000111001111111111110000000000000111111011111111101000000000
0000001111011111111111011000000011111111101011100101111100000000
0001111111111111111111111111111100001011111111111111111111111111
1111111111111111111111111111111111111110001110111111111011111110
