1000000000000000000000000000000000000000000000000000000000000000
1000000000000000000000000000000000000000000000000000000000000000
1000000000000000000000000000000000000000000000000000000000000000
1000000000000000000000000000000000111000000000000000000000000000
1000000000000000000000000000000000000000000111100000000000000000
1000000000000000000000000000000000000000111000000000000000000000
1000000000000000000000000000000000000000000000000000000000000000
1000000000000000000000000000000000000000000000000000000000000000
1000000000000000000000000000000000000000000000000000000000000000
1100000000000000000000000000000000000000000000000000000000000000
1100000000000000000000000000000000000000000000000000000000000000
1100000000000000000000000000000000000000000000000000000000000000
1100000000000000110000000000000000000000000000000000000000000000
1100000011111111111100011001111111111100000000000000000000000000
1100000000000000000011111111100000011110000000000000000000000000
1100000000000000000000000000000000000000000000000000000000000000
1100000000000000000000000000000000000000000000000000000000000000
1110000000000000000000000000000000000000000000000000000000000000
1110000000000000000000000000000000000000000000000000000000000000
1110000000000000000000000000000000000000000000000100011100000000
1110000010000000000000000000000000000000000000000111111000000000
1111000110000000000000000000000000000000000000000001100000000000
1111100110100000000000000000000000000000000000000000000000000000
1111111111100000000000000000000000000000000000000000000000000000
1111111111110000000000000000000000000000000000000000000000000000
1111111111111000000000000000000000000000000000000000000000000000
1111111011111000000000000000000000000000000000000000000000000000
1111110001111100000000000000000000000000000000000000000000000000
1110100000001100000000000000000000000000000000000000000000000000
1100000000001110000000000000000000000000000000000000000000000000
1100000000001110000000000001100111100111100000000000000000000000
1100000000000110000000000000111111111110000000000000000000000000
1100000000000000000000000000000000000000000000000000000000000000
1110000000000000000000000000000000000000000000000000000000000000
1110000000000000000000000000000000000000000000000000000000000000
1111000000000000000000000000000000000000000000000000000000000000
1111110000000000000000000000000000000000000000000000000000000000
1110111000000000000000000000000000000000000000000000000000000000
1111011111100000000000000000000000000000000000000000000000000000
1111111111111111111100000000000000000111111111111000000000000000
1110101110001100111111111111111111111111111000000100000000110000
1111111111111111111100011111111111110001111111111111111111111111
