1000000000000000000000000000000000000000000010000000000000000000
1000000000000000000000000000000000000000000111000000000000000000
1000000000000000000000000000000000000000001111000000000000000000
1100000000000000000000000001100000000000000000000000000000000000
1100000000000000000000000011110000000000000000000000000000000000
1110000000000000000000000011111000000000000000000000000000000000
1110000000000000000000000000010000000000000000000000000000000000
1110000000000000000000000000000000000000100000000000000000000000
1110000000000000000000000000000000000000100000000000000000000000
1110000000000000000000000000000000000000100000000000000000000000
1110000000000000000000000000000000000000100000000000000000000000
1110000000000000000000000000000000000000100000000000000000000000
1110000000000000010000000000000000000000110000000000000000000000
1111000000000000011000000000000000000000110000000000011000000000
1111000000000000011000000000000000000000110000000000011000000000
1111000000000000011000000000000000000001111000000000011100000000
1111000000000000011000000000000000000011111000000000001100000000
1010100000000000011000000000000000000011111000000000000000000000
1011100000000000011000000000000000000000111100000000000000000000
1111000000000000011000000000000000000000111110000000000000000000
1111000000000000011000000000000000000000111110000000000000000011
1111100000000000011000000000000000000000111000000000000000000011
1111100000000000011000000000000000000000111000000000000000000111
1111000000000011101000000000000000000000110000000000000000000011
1110000000000001111000000000000000000000100000000000000000000001
1010000000000000111000000000000000000000100000000000000000000000
1110000000000000111000000000000000000001100000000000000000000000
1100000000000000111110000000000000000001000000000000000000100000
1100000000000000111111000000000000000001000000000000000011100000
1100000000000000011111110000000000000001000000000000000011000000
1100000000000000000100000000000000000000000000000000000011000000
1100000000000000000000000000000000000000000000000000000010000000
1100000000000000000000000000000000000000000000000000000010000000
1100000000000000000000000000000000000000000000000000000000000000
1000000000000000000000000000000000000000000000000010000000000000
1000000000000000000000000100000000000000000000000010000000000000
1000000000000000000000000100000000000000000000000011100000000000
1000000000000000000000000100000000000000000000000111110000000000
1000000000000000000000000111000000000000000000000100010000000000
1000000000000000000000000111000000000000000000000000000000000000
1000000000000000000000001110110000000000000000000000000000000000
1000000000000000000000000110000000000000000000000000000000000000
